222222222222222222222222222222222222222222
222222222222222222222222222222222222222222
222222222222222222222222222222222222222222
222222222222222222222222222222222222222222
222222222222222222222222222222222222222222
222222221111111111111111111111111111112222
222222221000000000000000000000000000012222
222222221000000000000000000000000000012222
222222221000000000000000000000000000012222
222222221000000000000000000000000000012222
222222221000000000000000000000000000012222
222222221000000000000000000000000000012222
222222221000000000000000000000000000012222
222222221000000000000000000000000000012222
222222221000000000000000000000000000012222
222222221000000000000000000000000000012222
222222221111111111111111111111111111112222
222222222222222222222222222222222222222222
222222222222222222222222222222222222222222
222222222222222222222222222222222222222222
222222222222222222222222222222222222222222