22222222222222222222222222222222222222
22222222222222222222222222222222222222
22222222222222222222222222222222222222
22221111111111111111111111111111112222
22221000000000000000000000000000012222
22221000000000000000000000000000012222
22221000000000000000000000000000012222
22221000000000000000000000000000012222
22221000000000000000000000000000012222
22221000000000000000000000000000012222
22221000000000000000000000000000012222
22221000000000000000000000000000012222
22221000000000000000000000000000012222
22221000000000000000000000000000012222
22221111111111111111111111111111112222
22222222222222222222222222222222222222
22222222222222222222222222222222222222
22222222222222222222222222222222222222
22222222222222222222222222222222222222